111111P111111100111111C11111111111111111E11111111