1111111111100000111C11C11111111111111111E11111111
111111P111111111111111C11111110000001111011111111