1111111111111111111111111111111111
111E00000D00000C00000C0000000000C1
111001010010P000101001000000010101
1010010010101010001001000000010101
100000000C00C0000000000000000000D1
1111111111111111111111111111111111
