111111111111111111111111111111111111111111111111111
100000000000000000000000000000000000000000000000001
100000001000000000000000000000000000000000000000001
10000001E10000000000000000000000C000000000000000001
100000000000000000000000000000000000000000000000001
100000000000000000000000000000000000000000000000001
100001000000000000000000000000000000000000000100001
100000000000000000000000000000000000000000000000001
100000000000000000000000000000000000000000000000001
100000000000000000000001000000000000000000000000001
10000000000000000000001P100000000000000000000000001
100000000000000000000000000000000000000000000000001
111111111111111111111111111111111111111111111111111
