11111111111
10001000011
10001000011
10001000011
10001000011
10000000P01
11111111111