11111111111
10001000001
11111111111