11111111111111111111111111111111111111111111111111111111111111111111
11111111111111111111111111111111111111111111111111111111111111111111
11111111ECCCCCCCCCCCCCCCCCCCCCCCCCCCCCCC1111111111111111111111111111
111111111111111111111111111111111111111C1111111111111111111111111111
111111111111111111111111111111111111111C1111111111111111111111111111
111111111111111111111111111111111111111C1111111111111111111111111111
111111111111111111111111111111111111111C1111111111111111111111111111
111111111111111111111111111111111111111C1111111111111111111111111111
111111111111111111111111111111111111111C1111111111111111111111111111
111111111111111111111111111111111111111P1111111111111111111111111111
11111111111111111111111111111111111111111111111111111111111111111111
