111111111111111111111111111111111
100000000111000000001110000000011
100000000111000000001110000000011
100000000111000000001110000000011
100010000111000100001110001000011
10000000P011000000000110000000001
111111111111111111111111111111111