11111111111
10P01000001
11111111111